00000000000000000000
00000000000000000000
00000000000000000000
00000000000000000000
00000000000000000000
00000111111100000000
00000122432111000000
00000124343221000000
00000123434521000000
00000124343211000000
00000122432210000000
00000111111110000000
00000000000000000000
00000000000000000000
00000000000000000000
00000000000000000000
00000000000000000000
00000000000000000000
00000000000000000000
00000000000000000000