00000000000000000000
00000000000000000000
00000000000000000000
00000000000000000000
00000000000000000000
00000111110000000000
00000126510000000000
00000123310111000000
00000123210141000000
00000111211141000000
00000011222241000000
00000012221221000000
00000012221111000000
00000011111000000000
00000000000000000000
00000000000000000000
00000000000000000000
00000000000000000000
00000000000000000000
00000000000000000000