00000000000000000000
00000000000000000000
00000000000000000000
00000000000000000000
00000000000000000000
00000001111111000000
00001111222221000000
00001222411121000000
00001212122221100000
00001212323142100000
00001212222212100000
00001241323212100000
00001122221212111000
00000121114222251000
00000122222112221000
00000111111111111000
00000000000000000000
00000000000000000000
00000000000000000000
00000000000000000000